# # # # # # # # # # # # # # # # # #
# . . . . . . . # . . . . . . . . #
# . . . . . . . # . . . . . . . . #
# . . . . . . . # . . . . . . . . #
# . > . . . . . . . . . . . . . . #
# . . . . . . . # . . . . . . . . #
# . . . . . . . # . . . . . . . . #
# . . . . . . . # . . . . . . . . #
# # # # # # # # # # # # # # # # # #
