# # # # # . . # # # # # # # #
# . . . . . . . # . . . . . #
. . . . . . . . # . . . . . #
. . . . . . . . # . . . . . #
# . . . > . . . . . . . . . #
# . . . . . . . # . . . . . .
# . . . . . . . # . . . . . .
# . . . . . . . # . . . . . #
# # # # . . # # # # # # # # #
