# # # # # # # # #
# . . . . . . . #
# . . . . . . . #
# . . . . . . . #
# . > . . . . . #
# . . . . . . . #
# . . . . . . . #
# . . . . . . . #
# # # # # # # # #
