. . . . . . . . . . . . . . . . . . . . # # # # # # # # # # # # # # # # # . . .
. . . . . . . . . . . . . . . . . . . . # # # # # # . . . . . . . . . . # . . .
. . . . . . . . . . . . . . . . . . . . # # # # # # . . . . . . . . . . # . . .
. . . . . . . . . . . . . . . . . . . . # # # # # # . . . . . # # # . . # . . .
. . . . . . . . . . . . . . . . . . . . # # # # # # . . . . . . . # . . # . . .
. . . . . . . . . . . . . . . . . . . . # . . . . . . . . . . . . # . . # . . .
. . . . . . . . . . . . . . . . . . . . # . # # # # . . . . . . . # . . # . . .
. . . . . . . . . . . . . . . . . . . . # . # . . # . . . . . # # # . . # # # #
. . . . . . . . . . . . . . . . . . . . # . # . . # . . . . . . . . . . . . . #
. . . # # # # # # # # # # # # # # . # # # . # . . # . . . . . . . . . . # # . #
. . . # # # # # # # # # . . . . . . . . . . # . . # # # # # # # # # # # # # . #
. . . # # . . . # # # # . . . . . . . . . . # . . # # # # # # # # # # # . . . #
# # . # # . . . # # # # . . . # . . . # . . # . . # # # . . . . . . # # . . . #
# . . . # # # . # # # # . . . . . . . . . . # . . . . . . . . . . . . . . . . #
# . . . . . . . . . . . . > . . . . . . . . . . . . . . . . . . . . . . . # # #
# . . . # # # . # # # # . . . . . . . . . . # . . . . . . . . . . . . . . # # #
# # . # # . . . # # # # . . . # . . . # . . # . . . . . . # # # . . . . . # # #
. . . # # . . . # # # # . . . . . . . . . . # . . . . . . # # # . . . . . # # #
. . . # # # # # # # # # . . . . . . . . . . # . . . . . . # # # . . . . . # # #
. . . # # # # # # # # # # # # . . . . . # # # . . . . . . . . . . . . . . # # #
. . . . . . . . . . . # # # # . . . . . # # # . . . . . . . . . . . . . . # # #
. . . . . . . . . . . # # # # . . . . . # # # . . . . . . . . . . . . . . # # #
. . . . . . . . . . . # # # # # # # # # # # # . . . . . . . . . . . . . . # # #
. . . . . . . . . . . . . . . . . . . . # # # . . . . . . . . . . . . . . # # #
. . . . . . . . . . . . . . . . . . . . # # # # # # # # # # . . . # # # # # # #
