. . . . . . . . . . . . . . . . . . . . . . . . . # # # # # # # # # # # # . . .
. . . . . . . . . . . . . . . . . . . . . . . . . # . . . . . . . . . . # . . .
. . . . . . . . . . . . . . . . . . . . . . . . . # . . . . . . . . . . # . . .
. . . . . . . . . . . . . . . . . . . . . . . . . # . . . . . # # . . . # . . .
. . . . . . . . . . . . . . . . . . . # # # # # # # . . . . . . # . . . # . . .
. . . . . . . . . . . . . . . . . . . # . . . . . . . . . . . . # . . . # . . .
. . . . . . . . . . . . . . . . . . . # . . # # # # . . . . . . # . . . # . . .
. . . . . . . . . . . . . . . . . . . # . . # # # # . . . . . # # . . . # # # #
. . . . . . . . . . . . . . . . . . . # . . # # # # . . . . . . . . . . . . . #
. . . . . . . . . . . # # # # # # # # # . . # # # # . . . . . . . . . . . . . #
. . . . # # # # # . . # . . . . . . . . . . # # # # # # # # # # # # # # # . . #
. . . . # . . . # . . # . . . . . . . . . . # # # # # # # # # # # # # # # . . #
# # # # # . . . # . . # . . . # . . . # . . # . . . . . . . . . . . . . . . . #
# . . . # . . . # # # # . . . . . . . . . . # . . . . . . . . . . . . . . . . #
# . . . . . . . . . . . . . . . . . . . . . . . . . . . . . . . . . . . . # # #
# . . . # . . . # # # # . . . . . . . . . . # . . . . . . . . . . . . . . # . .
# # # # # . . . # . . # . . . # . . . # . . # . . . . . . # # # . . . . . # . .
. . . . # . . . # . . # . . . . . . . . . . # . . . . . . # # # . . . . . # . .
. . . . # # # # # . . # . . . . . . . . . . # . . . . . . # # # . . . . . # . .
. . . . . . . . . . . # # # # . . . . . # # # . . . . . . . . . . . . . . # . .
. . . . . . . . . . . . . . # . . ^ . . # . # . . . . . . . . . . . . . . # . .
. . . . . . . . . . . . . . # . . . . . # . # . . . . . . . . . . . . . . # . .
. . . . . . . . . . . . . . # # # # # # # . # . . . . . . . . . . . . . . # . .
. . . . . . . . . . . . . . . . . . . . . . # . . . . . . . . . . . . . . # . .
. . . . . . . . . . . . . . . . . . . . . . # # # # # # # # # # # # # # # # . .
